классификация - phân loại
обычно - thường
классифицировать - được phân loại
по - theo
тип - loại
траектория - quỹ đạo
полёт - bay
место - vị trí
направленность - hướng
запуск - phóng
дальность - tầm xa
двигатель - động cơ
боеголовка - đầu đạn
система - hệ thống
управление - điều khiển
наведение - dẫn đường
зависимость - phụ thuộc
различать - phân biệt
крылатый - cánh
беспилотный - không người lái
управляемый - điều khiển
до - đến
момент - khoảnh khắc
поражение - tiêu diệt
цель - mục tiêu
летательный - bay
аппарат - khí cụ
который - mà
поддерживаться - được duy trì
воздух - trên không
большой - lớn
часть - phần
свой - của nó
за - sau
счёт - nhờ
аэродинамический - khí động học
подъёмный - nâng
сила - lực
главный - chính
являться - là
значительный - đáng kể
расстояние - khoảng cách
межконтинентальный - liên lục địa
баллистический - đạn đạo
подразделять - được chia
на - thành
комплекс - tổ hợp
сверхвысокий - siêu cao
высокий - cao
точность - độ chính xác
достижение - đạt được
целевой - mục tiêu
канал - kênh
совокупность - tập hợp
элемент - thành phần
скорость - tốc độ
высота - độ cao
сверхзвуковой - siêu âm
дозвуковой - dưới âm thanh
широко - rộng rãi
известный - nổi tiếng
американский - Mỹ
ракета «Томагавк» - tên lửa "Tomahawk"
ниже - dưới
приводить - được liệt kê
схема - sơ đồ
российский - Nga
вооружение - trang bị
двигаться - di chuyển
около - khoảng
преодолевать - vượt qua
за - trong
секунда - giây
приблизительно - khoảng
модульный - mô-đun
конструкция - cấu trúc
способность - khả năng
запускать - phóng
под - dưới
различный - khác nhau
угол - góc
наклон - độ nghiêng
позволять - cho phép
носитель - bệ phóng
военный - quân sự
корабль - tàu chiến
подводный - ngầm
лодка - tàu ngầm
самолёт - máy bay
мобильный - di động
автономный - độc lập
пусковой - bệ phóng
установка - bệ phóng
масса - khối lượng
давать - cho
пробивной - xuyên phá
иметь - có
форма - dạng
парабола - parabol
дальнобойный - tầm xa
ближний - gần
максимальный - tối đa
зависеть - phụ thuộc