зенитная ракетная система - hệ thống tên lửa phòng không
совокупность зенитного ракетного комплекса - tổng hợp tổ hợp tên lửa phòng không
средство - phương tiện
обеспечение применения - đảm bảo sử dụng
зенитный ракетный комплекс - tổ hợp tên lửa phòng không
совокупность боевых средств - tổng hợp phương tiện chiến đấu
совокупность технических средств - tổng hợp phương tiện kỹ thuật
поражение - tiêu diệt
воздушная цель - mục tiêu trên không
зенитная управляемая ракета - tên lửa phòng không điều khiển
средство обнаружения - phương tiện phát hiện
средство опознавания - phương tiện nhận diện
средство целеуказания - phương tiện chỉ thị mục tiêu
средство управления полетом - phương tiện điều khiển chuyến bay
пусковая установка - bệ phóng
техническое средство - phương tiện kỹ thuật
электрический источник питания - nguồn điện
система управления зур - hệ thống điều khiển tên lửa phòng không
телеуправление зур - điều khiển từ xa tên lửa phòng không
самонаведение зур - tự dẫn đường tên lửa phòng không
комбинированное управление зур - điều khiển kết hợp tên lửa phòng không
боевое свойство - đặc tính chiến đấu
классификационный признак - đặc điểm phân loại
отнесение к типу - xếp vào loại
всепогодность - khả năng hoạt động mọi thời tiết
помехозащищенность - khả năng chống nhiễu
мобильность - tính cơ động
универсальность - tính đa năng
надежность - độ tin cậy
степень автоматизации - mức độ tự động hóa
процесс боевой работы - quy trình chiến đấu
уничтожение воздушной цели - tiêu diệt mục tiêu trên không
погодное условие - điều kiện thời tiết
всепогодный комплекс - tổ hợp hoạt động mọi thời tiết
невсепогодный комплекс - tổ hợp không hoạt động mọi thời tiết
условие помех - điều kiện nhiễu
противник - đối phương
подавление электронных средств - vô hiệu hóa thiết bị điện tử
оптическое средство - phương tiện quang học
транспортабельность - khả năng vận chuyển
время перехода - thời gian chuyển đổi
походное положение - trạng thái hành quân
боевое положение - trạng thái chiến đấu
суммарное время - tổng thời gian
смена стартовой позиции - thay đổi vị trí phóng
заданное условие - điều kiện cho trước
маневренность - tính cơ động chiến thuật
самоходный комплекс - tổ hợp tự hành
буксируемый комплекс - tổ hợp kéo theo
переносной комплекс - tổ hợp mang vác
стационарный комплекс - tổ hợp cố định
техническая возможность - khả năng kỹ thuật
диапазон дальностей - phạm vi tầm bắn
диапазон высот - phạm vi độ cao
нормальное функционирование - hoạt động bình thường
условие эксплуатации - điều kiện sử dụng
автоматический комплекс - tổ hợp tự động
полуавтоматический комплекс - tổ hợp bán tự động
неавтоматический комплекс - tổ hợp không tự động
операция - thao tác
обнаружение - phát hiện
сопровождение цели - theo dõi mục tiêu
наведение ракеты - dẫn đường tên lửa
автомат - máy móc
участие человека - sự tham gia của con người
число целевых каналов - số lượng kênh mục tiêu
число ракетных каналов - số lượng kênh tên lửa
одновременное сопровождение - theo dõi đồng thời
обстрел цели - bắn vào mục tiêu
одноканальный комплекс - tổ hợp đơn kênh
многоканальный комплекс - tổ hợp đa kênh
дальний действие - tầm xa
средняя дальность - tầm trung
малая дальность - tầm gần
ближнее действие - tầm ngắn
тактико-техническая характеристика - đặc tính kỹ thuật-tác chiến
боевая возможность - khả năng chiến đấu
назначение зрк - mục đích tổ hợp tên lửa phòng không
боевая задача - nhiệm vụ chiến đấu
дальность поражения - tầm tiêu diệt
вероятность поражения - xác suất tiêu diệt
минимальная дальность - tầm tối thiểu
максимальная дальность - tầm tối đa
высота поражения - độ cao tiêu diệt
минимальная высота - độ cao tối thiểu
максимальная высота - độ cao tối đa
численная величина - giá trị số
возможность поражения - khả năng tiêu diệt
условие стрельбы - điều kiện bắn
целевой канал - kênh mục tiêu
ракетный канал - kênh tên lửa
подготовка к старту - chuẩn bị phóng
старт - phóng
наведение на цель - dẫn đường đến mục tiêu
работное время - thời gian hoạt động
время реакции - thời gian phản ứng
интервал времени - khoảng thời gian
момент обнаружения - thời điểm phát hiện
пуск первой ракеты - phóng tên lửa đầu tiên
время перевода в боевое положение - thời gian chuyển sang trạng thái chiến đấu
готовность к открытию огня - sẵn sàng khai hỏa
время перевода в походное положение - thời gian chuyển sang trạng thái hành quân
построение походной колонны - bố trí đội hình hành quân
массовая характеристика - đặc tính khối lượng
предельная характеристика - đặc tính giới hạn
кабина зрк - cabin tổ hợp tên lửa phòng không
габаритная характеристика - đặc tính kích thước
внешнее очертание - đường viền ngoài
ширина - chiều rộng
длина - chiều dài
высота - chiều cao
зона поражения - khu vực tiêu diệt
область пространства - khu vực không gian
расчетное условие стрельбы - điều kiện bắn tính toán
заданная вероятность - xác suất cho trước
эффективность стрельбы - hiệu quả bắn
досягаемость комплекса - tầm với của tổ hợp
курсовой параметр - tham số đường bay