история советского ракетостроения - lịch sử xây dựng tên lửa Xô Viết
заслуга - công lao
развитие науки - phát triển khoa học
ракета - tên lửa
принадлежание - thuộc về
русский ученый - nhà khoa học Nga
изобретатель - nhà phát minh
константин эдуардович циолковский - Konstantin Eduardovich Tsiolkovsky
труд - công trình
разрабатывание - phát triển
теория реактивного движения - lý thuyết chuyển động phản lực
теория межпланетных сообщений - lý thuyết thông tin liên hành tinh
открытие - phát hiện
область аэродинамики - lĩnh vực khí động học
основа ракетостроения - cơ sở xây dựng tên lửa
теория полета ракеты - lý thuyết bay của tên lửa
к.э. циолковский - K.E. Tsiolkovsky
начало - bắt đầu
достижение - thành tựu
разработка теории - phát triển lý thuyết
ракетостроение - xây dựng tên lửa
награждение - trao tặng
орден трудового красного знамени - Huân chương Cờ Đỏ Lao Động
известность - nổi tiếng
признание - sự công nhận
советский союз - Liên Xô
зарубеж - nước ngoài
признанный глава - người đứng đầu được công nhận
направление - hướng
техника - kỹ thuật
воспитание - đào tạo
поколение - thế hệ
ученик - học trò
последователь - người theo sau
продолжатель дела - người tiếp nối sự nghiệp
ф.а. цандер - F.A. Tsander
м.к. тихонравов - M.K. Tikhonravov
советский конструктор - nhà thiết kế Liên Xô
ракетно-космическая система - hệ thống tên lửa-vũ trụ
сергей павлович королёв - Sergei Pavlovich Korolev
пуск - phóng
ракетный снаряд - đạn tên lửa
двигатель - động cơ
заряд - thuốc phóng
бездымный порох - thuốc súng không khói
испытание - thử nghiệm
создание - tạo ra
катюша - Katysha
огонь - ngọn lửa
ужас - kinh hoàng
враг - kẻ thù
роль - vai trò
разгром - đánh bại
немецко-фашистский захватчик - quân xâm lược Đức phát xít
период великой отечественной войны - giai đoạn Chiến tranh Vệ quốc Vĩ đại
теория - lý thuyết
практика создания ракеты - thực tiễn tạo ra tên lửa
довоенное время - thời kỳ tiền chiến
период войны - thời kỳ chiến tranh
бурное развитие - phát triển mạnh mẽ
ракетная техника - kỹ thuật tên lửa
послевоенное время - thời kỳ hậu chiến