принцип действия - nguyên lý hoạt động
система селекции движущихся целей - hệ thống chọn lọc mục tiêu di chuyển
защита - bảo vệ
пассивная помеха - nhiễu thụ động
экран индикатора - màn hình chỉ thị
затруднение - khó khăn
обнаружение - phát hiện
сопровождение - theo dõi
реальная цель - mục tiêu thực tế
искусственная пассивная помеха - nhiễu thụ động nhân tạo
естественная пассивная помеха - nhiễu thụ động tự nhiên
отражение зондирующего импульса - phản xạ xung thăm dò
объект - đối tượng
сбрасывание авиацией - thả từ máy bay
противник - kẻ thù
зона действия снр - khu vực hoạt động SNR
дипольный отражатель - bộ phản xạ lưỡng cực
уголковый отражатель - bộ phản xạ góc
полуволновой дипольный отражатель - bộ phản xạ lưỡng cực bán sóng
изготовление - chế tạo
металлизированное стекловолокно - sợi thủy tinh mạ kim loại
фольга - lá kim loại
пачка - bó
разрыв - rách
маскирующее облако - đám mây ngụy trang
диполь - lưỡng cực
эффективная отражающая поверхность - bề mặt phản xạ hiệu quả
местный предмет - vật thể địa phương
поверхность суши - bề mặt đất liền
облако - mây
гидрометеор - thủy tượng
зрк - hệ thống phòng không
маловысотный зрк - hệ thống phòng không thấp
влияние - ảnh hưởng
использование системы сдц - sử dụng hệ thống SDC
эффективность стрельбы - hiệu quả bắn
условие воздействия - điều kiện tác động
полезный сигнал - tín hiệu hữu ích
сигнал пассивной помехи - tín hiệu nhiễu thụ động
результат отражения - kết quả phản xạ
электромагнитный импульс - xung điện từ
наблюдательный пункт - điểm quan sát
отражающий объект - đối tượng phản xạ
источник колебаний - nguồn dao động
электромагнитный сигнал - tín hiệu điện từ
вторичный излучатель - bộ phát thứ cấp
частота колебаний - tần số dao động
перемещение - di chuyển
изменение - thay đổi
эффект доплера - hiệu ứng Doppler
звуковое колебание - dao động âm thanh
австрийский физик - nhà vật lý Áo
тон гудка поезда - âm thanh còi tàu
приближение - tiến lại gần
наблюдатель - người quan sát
понижение тона - giảm âm thanh
удаление - đi xa
экспериментальное доказательство - chứng minh thực nghiệm
электромагнитное колебание - dao động điện từ