разработка - phát triển
и - và
использование - sử dụng
ракетный - tên lửa
оружие - vũ khí
в - trong
военный - quân sự
цель - mục tiêu
являться - là
один - một
из - trong
ключевой - then chốt
направление - hướng
техника - kỹ thuật
современный - hiện đại
ракета - tên lửa
обладать - sở hữu
высокий - cao
точность - độ chính xác
мочь - có thể
использоваться - được sử dụng
для - để
различный - khác nhau
задача - nhiệm vụ
от - từ
уничтожение - tiêu diệt
бронированный - bọc thép
до - đến
поражение - tiêu diệt
стратегический - chiến lược
объект - mục tiêu
тактический - chiến thuật
оперативно-тактический - chiến thuật-hành động
поддержка - hỗ trợ
сухопутный - lục quân
войско - lực lượng
боевой - chiến đấu
действие - hành động
пускаться - được phóng
с - từ
платформа - bệ phóng
включать - bao gồm
грунтовый - mặt đất
мобильный - di động
установка - hệ thống
корабль - tàu chiến
баллистический - đạn đạo
разрабатываться - được phát triển
доставка - vận chuyển
ядерный - hạt nhân
конвенциональный - thông thường
боезаряд - đạn dược
большой - lớn
расстояние - khoảng cách
крылатый - cánh
отличаться - khác biệt
гибкость - linh hoạt
возможность - khả năng
облетать - bay vòng
препятствие - chướng ngại vật
благодаря - nhờ
аэродинамический - khí động học
характеристика - đặc tính
применение - sử dụng
требовать - yêu cầu
квалификация - trình độ
персонал - nhân sự
точный - chính xác
планирование - lập kế hoạch
операция - hoạt động
развитие - phát triển
технология - công nghệ
ракетостроение - xây dựng tên lửa
важный - quan trọng
фактор - yếu tố
усиление - tăng cường
обороноспособность - khả năng phòng thủ
страна - đất nước
новый - mới
позволять - cho phép
создавать - tạo ra
повышенный - tăng cường
скорость - tốc độ
эффективный - hiệu quả
поле - chiến trường
бой - chiến đấu
запускаться - được phóng
автомобиль - ô tô
самолёт - máy bay
удар - đòn
командный - chỉ huy
центр - trung tâm
противник - kẻ thù
система - hệ thống
управление - điều khiển
наведение - dẫn đường
совместный - chung
усилие - nỗ lực
учёный - nhà khoa học
инженер - kỹ sư