понятие - khái niệm
аэродинамическая сила - lực khí động học
взаимодействие - tương tác
летательный аппарат - khí tài bay
поток воздуха - dòng không khí
полная аэродинамическая сила - lực khí động học toàn phần
центр давления - tâm áp suất
элемент аппарата - yếu tố khí tài
центр масс - tâm khối
поступательное движение - chuyển động thẳng
вращение - xoay
механика - cơ học
перенос силы - chuyển lực
приложение силы - áp dụng lực
равная сила - lực bằng nhau
противоположно направленная сила - lực ngược chiều
вызывание - gây ra
аэродинамический момент - mô-men khí động học
вращение ракеты - xoay tên lửa
проекция - chiếu
ось - trục
скоростная система координат - hệ tọa độ tốc độ
подъемная сила - lực nâng
сила лобового сопротивления - lực cản đầu
боковая сила - lực bên
динамика полета - động học bay
скоростной напор - áp suất động
площадь крыла - diện tích cánh
коэффициент аэродинамической силы - hệ số lực khí động học
связанная система координат - hệ tọa độ liên kết
горизонтальная плоскость - mặt phẳng ngang
симметрия - đối xứng
момент рыскания - mô-men lệch hướng
вертикальная плоскость - mặt phẳng đứng
момент тангажа - mô-men nâng mũi
продольная ось - trục dọc
момент крена - mô-men nghiêng
стандартная форма - dạng chuẩn
запись момента - ghi mô-men
средняя аэродинамическая хорда - dây cung khí động học trung bình
размах крыла - sải cánh
определение коэффициента - xác định hệ số
задача аэродинамики - nhiệm vụ khí động học
тело простейшей формы - vật thể dạng đơn giản
угол атаки - góc tấn công
скольжение - trượt
аналитическое нахождение - tìm bằng phân tích
реальный летательный аппарат - khí tài bay thực tế
опытное определение - xác định thực nghiệm
продувка модели - thổi qua mô hình
аэродинамическая труба - đường hầm gió