контур - đường nét
управление - kiểm soát
зенитный - phòng không
управляемый - dẫn đường
ракета - tên lửa
текст - văn bản
зур - tên lửa dẫn đường phòng không
являться - là
активный - hoạt động
элемент - yếu tố
зрк - phức hợp tên lửa phòng không
непосредственно - trực tiếp
участвовать - tham gia
в - trong
поражение - đánh bại
цель - mục tiêu
часть - phần
элемент - các yếu tố
система - hệ thống
находиться - đặt tại
на - trên
земля - mặt đất
образовать - hình thành
мочь - có thể
и - và
или - hoặc
только - chỉ
борт - boong
это - cái này
замкнутый - khép kín
автоматический - tự động
конечный - cuối cùng
цель - mục đích
следовательно - do đó
траектория - quỹ đạo
должен - phải
проходить - đi qua
через - xuyên qua
точка - điểm
встреча - gặp gỡ
с - với
область - khu vực
огонь - lửa
центр - trung tâm
такой - như vậy
траектория - các quỹ đạo
мочь - có thể
быть - là
бесконечный - vô hạn
количество - số lượng
однако - tuy nhiên
нужно - cần
выбрать - chọn
какой - mà
обеспечивать - cung cấp
достижение - thành tựu
необходимый - cần thiết
расстояние - khoảng cách
до - đến
образ - cách
оптимизировать - tối ưu hóa
включать - bao gồm
выбор - lựa chọn
начальный - ban đầu
минимальный - tối thiểu
время - thời gian
полёт - chuyến bay
высокий - cao
вероятность - xác suất
поэтому - vì vậy
такой - như vậy
движение - chuyển động
который - mà
каждый - mỗi
момент - khoảnh khắc
определять - được xác định
бы - sẽ
параметр - tham số
закон - luật
зависимость - sự phụ thuộc
требуемый - yêu cầu
от - từ
называться - được gọi là
метод - phương pháp
определять - xác định
уравнение - phương trình
навигационный - dẫn đường
позволять - cho phép
оптимизировать - tối ưu
требуемый - yêu cầu
действительный - thực tế
отличаться - khác biệt
кинематический - động học
вследствие - do
инерционность - quán tính
линейный - tuyến tính
отклонение - sai lệch
называть - gọi là
рассогласование - không khớp
синхрон - đồng bộ
ошибка - lỗi
состав - thành phần
командный - lệnh
входить - bao gồm
система измерения координат - hệ thống đo lường tọa độ
управляемый блок - khối điều khiển
координата - tọa độ
начальная радиоуправляемая пу - bệ phóng vô tuyến ban đầu
зенитная управляемая ракета с системой стабилизации - tên lửa dẫn đường phòng không với hệ thống ổn định
кинематическое звено ракета - mắt xích động học của tên lửa
цель и система измерения координат цель находиться во внешней цепи - mục tiêu và hệ thống đo lường tọа độ mục tiêu nằm trong mạch ngoài
не входить в замкнутый контур - không thuộc về mạch kín
внешний - bên ngoài
возмущение - nhiễu loạn
замкнутый - kín
два - hai
стержень и рычаг - thanh và đòn bẩy
вместе они образовать - cùng nhau chúng tạo thành
кинематическая цепь - mắt xích động học
определять положение - xác định vị trí
тангенс угол - tiếp tuyến góc
вибрационный - rung động
подвижное звено - mắt xích di động
внешний контур - mạch ngoài
привод - động cơ
поиск - tìm kiếm
прицел - thị kính