антенна - anten
передающая антенна - anten phát
приемная антенна - anten thu
связная антенна - anten liên kết
радиолокационная антенна - anten radar
радионавигационная антенна - anten dẫn đường vô tuyến
телевизионная антенна - anten tivi
вибраторная антенна - anten rung
зеркальная антенна - anten gương
сопротивление - trở kháng
сопротивление антенны - trở kháng anten
фидер - phi đơ
коаксиальный фидер - phi đơ đồng trục
направленность - tính định hướng
характеристика направленности - đặc tính định hướng
диаграмма направленности - giản đồ định hướng
направленное действие - hoạt động định hướng
угол - góc
угол излучения - góc phát xạ
угол приёма - góc thu
приём - sự thu
приём волн - thu sóng
приёмная установка - thiết bị thu
передача - sự truyền
передача энергии - truyền năng lượng
передающая установка - thiết bị phát
линия - đường
линия передачи - đường truyền
конструкция - cấu trúc
конструкция антенны - cấu trúc anten
конструкция фидерной линии - cấu trúc đường truyền phi đơ
конструктивная особенность - đặc điểm cấu trúc
диапазон - dải
диапазон волн - dải sóng
параметр - tham số
электрический параметр - tham số điện
параметр антенны - tham số anten
коэффициент - hệ số
коэффициент направленного действия - hệ số định hướng
коэффициент полезного действия - hệ số hiệu dụng
коэффициент усиления антенны - hệ số khuếch đại anten
труба - ống
полая труба - ống rỗng
металлическая труба - ống kim loại
волновод - ống dẫn sóng
волновод с прямоугольным сечением - ống dẫn sóng tiết diện hình chữ nhật
волновод с круглым сечением - ống dẫn sóng tiết diện hình tròn
свойство - tính chất
свойство обратимости - tính chất thuận nghịch