назначение - mục đích
состав - thành phần
основной принцип - nguyên tắc cơ bản
построение - xây dựng
ракетный комплекс - tổ hợp tên lửa
бортовая аппаратура - thiết bị trên máy bay
управление полетом - điều khiển chuyến bay
ракета - tên lửa
составная часть - phần cấu thành
система управления полетом - hệ thống điều khiển chuyến bay
устройство - cấu trúc
определять - xác định
принятая система управления - hệ thống điều khiển được chấp nhận
реализовать - thực hiện
зрк - hệ thống phòng không
система теленаведения - hệ thống dẫn đường từ xa
самонаведение - tự dẫn đường
координатор - bộ điều phối
цель - mục tiêu
счетно-решающий прибор - thiết bị tính toán quyết định
срп - thiết bị tính toán
измерять - đo lường
параметр рассогласования - tham số sai lệch
сигнал ошибки - tín hiệu lỗi
выдавать - đưa ra
напряжение рассогласования - điện áp sai lệch
величина - độ lớn
знак - dấu hiệu
формировать - hình thành
команда управления - lệnh điều khiển
составляющая компенсации - thành phần bù đắp
ошибка наведения - sai lệch dẫn đường
выход - đầu ra
поступать - đến
автопилот - bộ tự lái
ап - bộ tự lái
управление рулем - điều khiển cánh lái
командная система - hệ thống lệnh
наведение - dẫn đường
телеуправление - điều khiển từ xa
получать - nhận
наземное средство - phương tiện mặt đất
сигнал управления - tín hiệu điều khiển
условие - điều kiện
приводить - đưa vào hoạt động
руль - cánh lái
отклонять - làm lệch
требуемая величина - độ lớn yêu cầu
сигнал ошибки - tín hiệu lỗi
отклонение - sự lệch
требуемое направление - hướng yêu cầu
характерная особенность - đặc điểm nổi bật
бортовой координатор - bộ điều phối trên máy bay
использование - sử dụng
равносигнальный метод - phương pháp đồng tín hiệu
измерение текущих координат - đo lường tọa độ hiện tại
цель пеленгации - mục tiêu định vị
антенная система - hệ thống anten
роль - vai trò
угловой датчик - cảm biến góc
зависимость - sự phụ thuộc
построение системы - xây dựng hệ thống
извлечение информации - trích xuất thông tin
угловое положение - vị trí góc
амплитудный - biên độ
фазовый - pha
соотношение выходного сигнала - mối quan hệ tín hiệu đầu ra
подразделять - chia thành
амплитудная пеленгация - định vị biên độ
фазовая пеленгация - định vị pha
определение угловых координат - xác định tọa độ góc
совмещение равносигнального направления - kết hợp hướng đồng tín hiệu
направление рсн - hướng RSN
антенна - anten
направление цели - hướng mục tiêu
управление зур - điều khiển ZUR
осуществлять - thực hiện
вариант - phương án
настоящее время - hiện tại
применение - ứng dụng
командное телеуправление - điều khiển từ xa bằng lệnh
первый вид ту-1 - loại thứ nhất TU-1
второй вид ту-2 - loại thứ hai TU-2
первый вариант - phương án đầu tiên
наземное средство наведения - phương tiện dẫn đường mặt đất
информация положения - thông tin vị trí
ракета - tên lửa
цель - mục tiêu
вырабатывать - tạo
преобразовывать - chuyển đổi
команда - lệnh
второй вариант - phương án thứ hai
борт - máy bay
передавать - truyền
стабилизация - ổn định
угловое движение - chuyển động góc
центр масс - tâm khối
положение - vị trí
пространство - không gian
система стабилизации - hệ thống ổn định
элемент - yếu tố
система управления - hệ thống điều khiển
противо-корабельная крылатая ракета - tên lửa hành trình chống tàu
береговой ракетный комплекс - tổ hợp tên lửa bờ biển
к300 бастион - K300 Bastion
поражение - tiêu diệt
надводный корабль - tàu mặt nước
класс - lớp
тип - loại
десантное соединение - đơn vị đổ bộ
конвой - đoàn tàu
корабельная ударная группа - nhóm tấn công tàu chiến
авианосная ударная группа - nhóm tấn công tàu sân bay
одиночный корабль - tàu đơn lẻ
надводная радиоконтрастная цель - mục tiêu phản xạ sóng radio trên mặt nước
наземная радиоконтрастная цель - mục tiêu phản xạ sóng radio trên mặt đất
условие - điều kiện
огневое противодействие - chống đối hỏa lực
радиотехническое противодействие - chống đối kỹ thuật radio
унифицированная сверхзвуковая ракета - tên lửa siêu thanh thống nhất
исполнять - thực hiện
вариант - biến thể
подвижный вариант - biến thể di động
колёсное шасси - khung gầm bánh xe
стационарный вариант - biến thể cố định
шахтное базирование - căn cứ silo
противокорабельная ракета - tên lửa chống tàu
п-800 оникс - P-800 Onyx
транспортно-пусковой стакан - ống phóng vận chuyển
тпс - ống phóng vận chuyển
самоходная пусковая установка - bệ phóng tự hành
машина боевого управления - xe điều khiển chiến đấu
аппаратура информационно-технического сопряжения - thiết bị kết nối thông tin-kỹ thuật
боевое средство - phương tiện chiến đấu
головной командный пункт - sở chỉ huy chính
транспортно-заряжающая машина - xe vận chuyển nạp đạn
машина обеспечения боевого дежурства - xe đảm bảo trực chiến
комплекс средств технического обслуживания - tổ hợp phương tiện bảo dưỡng kỹ thuật
учебно-тренировочное средство - phương tiện huấn luyện
дальность боевого применения - tầm bắn chiến đấu
полёт ракеты - chuyến bay tên lửa
комбинированная траектория - quỹ đạo kết hợp
низко-высотная траектория - quỹ đạo thấp
высота полёта ракеты - độ cao bay của tên lửa
маршевый участок - đoạn hành trình
конечный участок - đoạn cuối
четырёхосное шасси - khung gầm bốn trục
количество ракет - số lượng tên lửa
угол пуска - góc phóng
максимальная скорость - tốc độ tối đa
запас хода - tầm hoạt động
k380p - K380P
трёхосное шасси - khung gầm ba trục
время приведения комплекса - thời gian đưa tổ hợp
боевая готовность - trạng thái sẵn sàng chiến đấu
походное положение - trạng thái hành quân
время автономного боевого дежурства - thời gian trực chiến độc lập
стартовая батарея - cụm phóng
стационарная защищённая пусковая установка - bệ phóng cố định được bảo vệ
модуль управления - mô-đun điều khiển
стационарный защищённый командный пункт - sở chỉ huy cố định được bảo vệ
автоматизированная система - hệ thống tự động
боевое управление комплексом - điều khiển chiến đấu tổ hợp
мобильный командный пункт - sở chỉ huy di động
вертолётный комплекс - tổ hợp trực thăng
целеуказание - chỉ thị mục tiêu