общий сведение - thông tin chung
радиолокация - radar
область радиотехники - lĩnh vực kỹ thuật radio
отражение - phản xạ
переизлучение - tái phát
собственное излучение - phát xạ tự nhiên
электромагнитная радиоволна - sóng radio điện từ
обнаружение - phát hiện
различная цель - mục tiêu khác nhau
объект - đối tượng
измерение - đo lường
координата - tọa độ
параметр движения - thông số chuyển động
радиолокационная цель - mục tiêu radar
материальный объект - đối tượng vật chất
местоположение - vị trí
метод радиолокации - phương pháp radar
совокупность сведений - tổng hợp thông tin
радиолокационная информация - thông tin radar
техническое средство - phương tiện kỹ thuật
получение радиолокационной информации - nhận thông tin radar
радиолокационная станция - trạm radar
радиолокатор - radar
самолёт - máy bay
ракета - tên lửa
искусственный спутник земли - vệ tinh nhân tạo Trái Đất
танк - xe tăng
корабль - tàu thuyền
облако - mây
планета - hành tinh
ориентир на местности - mốc định vị trên địa hình
свойство радиоволны - tính chất sóng radio
закономерность распространения - quy luật lan truyền
физическая основа - cơ sở vật lý
создание рлс - tạo trạm radar
русский изобретатель радио - nhà phát minh radio Nga
опыт - thí nghiệm
возможность использования - khả năng sử dụng
радиоволна - sóng radio
измерение направления - đo hướng
назначение - mục đích
основа работы - cơ sở hoạt động
положение - nguyên tắc
облучение радиоволнами - chiếu xạ bởi sóng radio
электромагнитная энергия - năng lượng điện từ
прямолинейное распространение - lan truyền thẳng
постоянная скорость - tốc độ không đổi
антенна радиолокационной станции - anten trạm radar
направленное излучение - phát xạ định hướng
приём электромагнитной энергии - thu năng lượng điện từ
современная радиолокационная станция - trạm radar hiện đại
радиотехническое устройство - thiết bị kỹ thuật radio
передатчик - bộ phát
кратковременная генерация - tạo dao động ngắn hạn
колебание - dao động
сверхвысокая частота - tần số cực cao
антенна направленного действия - anten định hướng
зондирующий радиоимпульс - xung radio thăm dò
пространство - không gian
скорость света - tốc độ ánh sáng
облучение цели - chiếu xạ mục tiêu
отражение радиоволн - phản xạ sóng radio
линейный размер - kích thước tuyến tính
длина волны - bước sóng
отражённая радиоволна - sóng radio phản xạ
автоматический антенный переключатель - công tắc anten tự động
приёмник - bộ thu
излучение зондирующего радиоимпульса - phát xung radio thăm dò
отражённый радиоимпульс - xung radio phản xạ
усиление - khuếch đại
преобразование - chuyển đổi
видеоимпульс - xung video
прямоугольная форма - hình chữ nhật
выход приёмника - đầu ra bộ thu
индикатор - chỉ thị
экран - màn hình
электронно-лучевая трубка - ống tia cathode
угловая координата цели - tọa độ góc mục tiêu
положение антенны - vị trí anten
перемещение - di chuyển
азимут - phương vị
угол - góc
горизонтальная плоскость - mặt phẳng ngang
условное направление - hướng quy ước
нулевое направление - hướng số không
направление цели - hướng mục tiêu
угол места - góc cao độ
вертикальная плоскость - mặt phẳng đứng
горизонт - đường chân trời
наклонная дальность - khoảng cách nghiêng
высота - độ cao
точность определения координат - độ chính xác xác định tọа độ
характеристика направленности - đặc tính định hướng
укорочение радиоволн - ngắn lại sóng radio
причина освоения - lý do khai thác
короткая волна - sóng ngắn
радиотехнический комплекс - tổ hợp kỹ thuật radio
устройство автоматики - thiết bị tự động
вычислительная техника - kỹ thuật tính toán
войска - quân đội
радиолокационная техника - kỹ thuật radar
своевременное обнаружение - phát hiện kịp thời
самолёт-снаряд - máy bay mang đạn
управление истребителями - điều khiển máy bay tiêm kích
реактивный снаряд - đạn phản lực
борьба - đấu tranh
средство воздушного нападения - phương tiện tấn công trên không