количество - số lượng
тип ракетного оружия - loại vũ khí tên lửa
принципиальная схема - sơ đồ nguyên lý
устройство - cấu trúc
стартовое оборудование - thiết bị khởi động
пусковое оборудование - thiết bị phóng
ракета - tên lửa
пусковая установка - bệ phóng
подъемно-транспортная машина - máy vận chuyển nâng hạ
агрегат - cụm
заправочная машина - máy nạp nhiên liệu
контрольно-измерительная машина - máy kiểm tra đo lường
прибор наведения - thiết bị dẫn đường
прибор управления - thiết bị điều khiển
назначение - mục đích
средство запуска - phương tiện phóng
способ управления полетом - cách điều khiển chuyến bay
принцип наведения на цель - nguyên tắc dẫn đường đến mục tiêu
дальность стрельбы - tầm bắn
управляемая ракета - tên lửa điều khiển
головная часть - phần đầu
боевой заряд - đạn chiến đấu
взрыватель - ngòi nổ
двигатель - động cơ
стабилизирующее устройство - thiết bị ổn định
силовой корпус - thân lực
неуправляемая ракета - tên lửa không điều khiển
точность стрельбы - độ chính xác bắn
преимущество - lợi thế
простота устройства - sự đơn giản cấu trúc
вес - trọng lượng
габарит - kích thước
боевая готовность - sẵn sàng chiến đấu
скорострельность - tốc độ bắn
сложная конструкция - cấu trúc phức tạp
баллистическая ракета - tên lửa đạn đạo
одноступенчатая баллистическая ракета - tên lửa đạn đạo một tầng
носовой конус - mũi hình nón
защита - bảo vệ
аэродинамический нагрев - nhiệt khí động học
боевая часть - phần chiến đấu
отсек приборов управления - khoang thiết bị điều khiển
полет по заданной траектории - chuyến bay theo quỹ đạo cho trước
отсек топливного бака - khoang bình nhiên liệu
отсек твердого топлива - khoang nhiên liệu rắn
камера сгорания - buồng đốt
сопло - vòi phun
стабилизатор - bộ ổn định
последовательное расположение - bố trí tuần tự
ступень - tầng
первая ступень - tầng đầu tiên
вторая ступень - tầng thứ hai
третья ступень - tầng thứ ba
цилиндрический переходник - bộ nối hình trụ
жрд первой ступени - động cơ tầng đầu tiên
силовой узел связи ступеней - nút kết nối lực giữa các tầng
конический переходник - bộ nối hình nón
жрд второй ступени - động cơ tầng thứ hai
юбка - phần đuôi
хвостовой отсек - khoang đuôi
пакетная схема - sơ đồ bó
подвесной боковой стартовый бак - bình khởi động bên hông
центральный блок - khối trung tâm
корпус третьей ступени - thân tầng thứ ba
жрд третьей ступени - động cơ tầng thứ ba
схема устройства - sơ đồ cấu trúc
многоступенчатая ракета - tên lửa nhiều tầng
дальность полета - tầm bay
применение - sử dụng
самостоятельная ракета - tên lửa độc lập
соединение - kết nối
стартовый пороховой реактивный двигатель - động cơ phản lực bột khởi động
приборный отсек - khoang thiết bị
сообщение скорости - cung cấp tốc độ
первая скорость - tốc độ đầu tiên
дополнительная вторая скорость - tốc độ thứ hai bổ sung
дополнительная третья скорость - tốc độ thứ ba bổ sung
полная скорость - tốc độ tổng cộng
полезный груз - tải trọng hữu ích
стартовый вес - trọng lượng khởi động
расход топлива - tiêu thụ nhiên liệu
энергия - năng lượng
отделяющаяся ступень - tầng tách rời
стрельба на большое расстояние - bắn ở khoảng cách xa
элемент конструкции - yếu tố cấu trúc