исследование движения - nghiên cứu chuyển động
использование системы координат - sử dụng hệ tọa độ
земная система координат - hệ tọa độ Trái Đất
связанная система координат - hệ tọa độ liên kết
положение ракеты - vị trí tên lửa
пространство - không gian
определение - xác định
координата - tọa độ
начало системы - điểm bắt đầu hệ thống
точка пуска - điểm phóng
касательная - tiếp tuyến
дуга земной поверхности - cung bề mặt Trái Đất
перпендикуляр - vuông góc
вращающаяся земля - Trái Đất quay
изменение положения - thay đổi vị trí
вращение земли - sự quay của Trái Đất
траектория ракеты - quỹ đạo tên lửa
рассчитывание - tính toán
траектория относительного движения - quỹ đạo chuyển động tương đối
относительная система координат - hệ tọa độ tương đối
центр тяжести - tâm trọng lực
продольная ось - trục dọc
нормальная ось - trục bình thường
поперечная ось - trục ngang
плоскость х1у1 - mặt phẳng X1Y1
плоскость ху - mặt phẳng XY
ориентирование - định hướng
жесткое тело - vật rắn
угол тангажа - góc nâng mũi
плоскость xgзg - mặt phẳng XgZg
стартовый горизонт - đường chân trời khởi động
угол рыскания - góc lệch hướng
плоскость xgуg - mặt phẳng XgYg
угол крена - góc nghiêng
поворот корпуса - xoay thân
полет ракеты - chuyến bay tên lửa
внешняя сила - lực ngoài
сила тяги - lực kéo
реактивный двигатель - động cơ phản lực
сила тяжести - lực hấp dẫn
вес - trọng lượng
аэродинамическая сила - lực khí động học
сила органа управления - lực điều khiển
газодинамическая сила - lực khí động học
сила инерции кориолиса - lực quán tính Coriolis
действие силы - tác động lực
траектория одноступенчатой ракеты - quỹ đạo tên lửa một tầng
баллистическая ракета - tên lửa đạn đạo
вертикальный старт - phóng thẳng đứng
участок траектории - đoạn quỹ đạo
активный участок - đoạn chủ động
разреженный слой атмосферы - lớp loãng khí quyển
плотный слой атмосферы - lớp dày khí quyển
направление движения - hướng di chuyển
подъем ракеты - độ cao tăng của tên lửa
пассивный участок - đoạn thụ động
точка выключения двигателя - điểm tắt động cơ
конец активного участка - kết thúc đoạn chủ động
конец вертикального подъема - kết thúc đoạn bay thẳng đứng
наибольшая высота - độ cao lớn nhất
направление вниз - hướng xuống
центр земли - tâm Trái Đất
выгорание топлива - cháy nhiên liệu
изменение ускорения - thay đổi gia tốc
ускорение - gia tốc
ракета средней дальности - tên lửa tầm trung
ракета большой дальности - tên lửa tầm xa
географическая широта - vĩ độ địa lý
величина дуги меридиана - độ lớn cung kinh tuyến
экватор - xích đạo
заданная точка - điểm cho trước
сила сопротивления воздуха - lực cản không khí
размер - kích thước
форма - hình dạng
скорость - tốc độ
высота - độ cao
угол атаки - góc tấn công
угол скольжения - góc trượt
газовый руль - cánh lái khí
шарнир управляющего органа - bản lề cơ quan điều khiển
сила сопротивления рулей - lực cản cánh lái
подъемная сила рулей - lực nâng cánh lái
влияние вращения земли - ảnh hưởng sự quay của Trái Đất
отклонение ракеты - lệch tên lửa
точка цели - điểm mục tiêu
боковое направление - hướng ngang
пуск вдоль меридиана - phóng dọc kinh tuyến
пуск вдоль экватора - phóng dọc xích đạo
восток - phía đông
увеличение дальности - tăng tầm bay
запад - phía tây
уменьшение дальности - giảm tầm bay