зенитная управляемая ракета - tên lửa phòng không điều khiển
зур - ZUR
активный элемент - yếu tố chủ động
зенитно-ракетный комплекс - tổ hợp tên lửa phòng không
зрк - ZRK
поражение цели - tiêu diệt mục tiêu
элемент системы управления - yếu tố hệ thống điều khiển
непрерывное наведение - dẫn đường liên tục
цель - mục tiêu
система наведения зрк - hệ thống dẫn đường ZRK
контур управления зур - mạch điều khiển ZUR
замкнутая система автоматического управления - hệ thống điều khiển tự động khép kín
место расположения - vị trí đặt
земля - đất
борт ракеты - boong tên lửa
траектория ракеты - quỹ đạo tên lửa
точка встречи - điểm gặp
техническое средство - phương tiện kỹ thuật
тактическая точка зрения - góc độ chiến thuật
время полёта - thời gian bay
вероятность поражения - xác suất tiêu diệt
движение ракеты - chuyển động tên lửa
момент времени - thời điểm
параметр движения цели - tham số chuyển động mục tiêu
закон сближения - quy luật tiếp cận
зависимость параметров - sự phụ thuộc của tham số
метод наведения зур - phương pháp dẫn đường ZUR
кинематическая траектория - quỹ đạo động học
требуемая траектория - quỹ đạo yêu cầu
действительная траектория полёта - quỹ đạo bay thực tế
инерционность зур - quán tính ZUR
возмущение - nhiễu
линейное отклонение - sai lệch tuyến tính
параметр рассогласования - tham số không khớp
сигнал ошибки - tín hiệu lỗi
командная система телеуправления - hệ thống điều khiển từ xa bằng lệnh
автопилот - tự lái
корпус ракеты - thân tên lửa
обратная связь - phản hồi ngược
управляющий блок - khối điều khiển
кинематическое звено - liên kết động học
система измерения координат зур - hệ thống đo tọa độ ZUR
система измерения координат цели - hệ thống đo tọa độ mục tiêu
внешняя цепь - chuỗi ngoài
замкнутый контур - mạch khép kín
источник внешних возмущений - nguồn nhiễu ngoài
сбор информации - thu thập thông tin
обработка информации - xử lý thông tin
координата цели - tọa độ mục tiêu
координата зур - tọa độ ZUR
счётно-решающий прибор - thiết bị tính toán và quyết định
разность угловых координат - sự khác biệt tọa độ góc
команда управления - lệnh điều khiển
линия радиоуправления - đường dây radio điều khiển
отклонение рулей - lệch cánh lái
нормальная сила - lực bình thường
сближение ракеты - đưa tên lửa lại gần
уменьшение параметра рассогласования - giảm tham số không khớp
изменение координат - thay đổi tọa độ
измерительное устройство - thiết bị đo lường
поправка - điều chỉnh
вывод ракеты - đưa tên lửa
колебательное движение - dao động
процесс наведения - quá trình dẫn đường