основной - cơ bản
определение - định nghĩa
оба - cả hai
система - hệ thống
зенитный - phòng không
ракетный - tên lửa
оружие - vũ khí
зенитная ракетная система - hệ thống phòng không tên lửa
совокупность - tập hợp
комплекс - tổ hợp
зрк - tổ hợp phòng không tên lửa
средство - phương tiện
обеспечивать - đảm bảo
его - của nó
применение - sử dụng
функциональный - chức năng
связанный - liên kết
боевой - chiến đấu
технический - kỹ thuật
предназначенный - được thiết kế
для - để
поражение - tiêu diệt
воздушный - trên không
цель - mục tiêu
управляемый - điều khiển
состав - thành phần
входить - bao gồm
обнаружение - phát hiện
опознавание - nhận diện
целеуказание - chỉ thị mục tiêu
управление - điều khiển
пополт - toàn bộ
зур - tên lửa phòng không
пусковая установка - bệ phóng
пу - bệ phóng
электрический - điện
источник - nguồn
питание - cung cấp
основа - nền tảng
составлять - tạo thành
задача - chỉ thị
телеуправление - điều khiển từ xa
самонаведение - tự dẫn
комбинированный - kết hợp
каждый - mỗi
обладать - có
определённый - nhất định
общий - chung
свойство - đặc tính
особенность - đặc điểm
который - mà
мочь - có thể
служить - phục vụ
классификационный - phân loại
признак - đặc điểm
позволять - cho phép
отнести - xếp vào
тип - loại
всеподобность - toàn diện
помехозащищённость - khả năng chống nhiễu
мобильность - tính cơ động
универсальность - tính đa năng
надежность - độ tin cậy
степень - mức độ
автоматизация - tự động hóa
процесс - quá trình
ведение - tiến hành
работа - nhiệm vụ
и др - và các thứ khác
способность - khả năng
уничтожать - tiêu diệt
условие - điều kiện
помеха - nhiễu
создавать - được tạo ra
противник - đối phương
электронный - điện tử
кратчайший - ngắn nhất
срок - thời gian
производить - thực hiện
транспортировка - vận chuyển
временный - tạm thời
переход - chuyển đổi
относительный - tương đối
показатель - chỉ số
взлёт - cất cánh
самоходный - tự hành
буксируемый - kéo theo
переносной - mang vác
немобильный - không cơ động
называть - gọi là
стационарный - cố định
характеризовать - đặc trưng
возможность - khả năng
применение - sử dụng
различный - khác nhau
вид - loại
наведение - dẫn đường
ракета - tên lửa
весь - tất cả
операция - hoạt động
сопровождение - đồng hành
автоматизировать - tự động hóa
полуавтоматический - bán tự động
неавтоматический - không tự động
решение - quyết định
запуск - phóng
принимать - quyết định
человек - con người
различать - phân biệt
по - theo
число - số lượng
канал - kênh
одновременный - đồng thời
обстрел - bắn
одноканальный - một kênh
многоканальный - đa kênh
дальность - tầm xa
стрельба - bắn
подразделять - được chia
дальний - tầm xa
действие - tác chiến
дд - tầm xa
средний - tầm trung
малый - tầm ngắn
ближний - tầm rất ngắn
бд - tầm rất ngắn
тактико-технический - tác chiến-kỹ thuật
характеристика - đặc tính
ттх - tác chiến-kỹ thuật
определять - xác định
боевой - chiến đấu
назначение - nhiệm vụ
обобщённый - tổng quát
указывать - chỉ ra
область - khu vực
задача - nhiệm vụ
решать - được giải quyết
посредством - bằng cách
данный - của
минимальный - tối thiểu
максимальный - tối đa
высота - độ cao
поражать - bị tiêu diệt
вероятность - xác suất
ниже - dưới
заданный - đã cho
вертолёт - trực thăng
численность - số lượng
установка - bệ phóng
реализовать - được thực hiện
несколько - nhiều
высокий - cao
открытый - ngoài trời
закрытый - trong nhà
расположение - vị trí
низкий - thấp
приводить - dẫn đến
необходимость - sự cần thiết
специальный - chuyên dụng
транспортный - vận chuyển
перевозка - vận chuyển
установка - lắp đặt
предусмотренный - được quy định
позиция - vị trí
элемент - thành phần
обеспечивать - đảm bảo
управление - điều khiển
наведение - dẫn đường
на - vào
рабочий - làm việc
время - thời gian
реакция - phản ứng
интервал - khoảng cách
между - giữa
момент - khoảnh khắc
обнаружение - phát hiện
начало - bắt đầu
действие - hành động
по - theo
уничтожение - tiêu diệt
наличие - có
возможный - có thể
работа - hoạt động
перевод - chuyển đổi
положение - trạng thái
передвижение - di chuyển
наоборот - ngược lại
зависеть - phụ thuộc
от - vào
конструкция - cấu trúc
условие - điều kiện
массовый - khối lượng
предельный - giới hạn
кабина - ca-bin
габаритный - kích thước
внешний - bên ngoài
очертание - đường nét
приведённый - được liệt kê
таблица - bảng
зона - khu vực
пространство - không gian
предел - giới hạn
расчётный - tính toán