классификация - phân loại
и - và
назначение - mục đích
ракетный - tên lửa
оружие - vũ khí
текст - văn bản
ракета - tên lửa
являться - là
самый - nhất
совершенный - hoàn hảo
мощный - mạnh mẽ
средство - phương tiện
вооружённый - vũ trang
сила - lực lượng
они - chúng
обладать - sở hữu
значительный - đáng kể
дальность - tầm xa
действие - hành động
огромный - khổng lồ
поражающий - phá hủy
свойство - tính chất
высокий - cao
точность - độ chính xác
поражение - tiêu diệt
цель - mục tiêu
классифицироваться - được phân loại
по - theo
следующий - sau
признак - đặc điểm
принадлежность - thuộc về
к - đến
вид - loại
вооружение - vũ trang
место - vị trí
конструктивный - cấu trúc
особенность - đặc điểm
применение - sử dụng
топливо - nhiên liệu
характер - đặc tính
траектория - quỹ đạo
способ - cách thức
управление - điều khiển
боевой - chiến đấu
характеристика - đặc tính
заряд - đạn dược
делиться - được chia
на - thành
пво - phòng không
стратегический - chiến lược
ввс - không quân
ивс - không quân
страй - tấn công
сухопутный - lục quân
войско - quân đội
военно-воздушный - không quân
военно-морской - hải quân
флот - hạm đội
такой - như vậy
деление - phân chia
обусловленный - được quy định
в - trong
основной - chủ yếu
ведение - tiến hành
действие - hành động
кадрило - đội hình
театр - chiến trường
военный - quân sự
сложность - độ phức tạp
ракета - tên lửa
присваивать - gán
класс - lớp
земля - đất
котёл - nồi
наземный - mặt đất
станок - trạm
объект - đối tượng
на - trên
воздух - không khí
самолёт - máy bay
другой - khác
летательный - bay
аппарат - thiết bị
лишь - chỉ
бележитосный - quyền lực
власть - quyền lực
корабль - tàu
подводный - ngầm
лодка - tàu ngầm
подкласс - tiểu lớp
баллистический - đạn đạo
крылатый - cánh
противотанковый - chống tăng
управляемый - điều khiển
зенитный - phòng không
воздух-боевой - không-chiến đấu
написание - cách viết
удар - đòn
по - vào
ядерный - hạt nhân
нападение - tấn công
противник - kẻ thù
длительный - lâu dài
артиллерия - pháo binh
танк - xe tăng
бронетранспортёр - xe bọc thép
живой - sống
сила - lực lượng
как - như
ход - quá trình
наступление - tấn công
оборона - phòng thủ
тактический - chiến thuật
мочь - có thể
быть - là
неуправляемый - không điều khiển
жидкостный - lỏng
твердотопливный - nhiên liệu rắn
длительность - thời gian
полёт - bay
оснащаться - được trang bị
бортовой - trên máy bay
система - hệ thống
пуск - khởi động
подвижный - di động
стартовый - bệ phóng
установка - hệ thống
способный - có khả năng
перемещаться - di chuyển
совместно - cùng với
войско - quân đội
к - đối với
коробельный - tàu chiến
один - một
из - trong
основной - chính
современный - hiện đại
война - chiến tranh